#################################
#P_____________________________E#
#_______________________________#
#_______________________________#
#_______________________________#
#_______________________________#
#_______________________________#
#_______________________________#
#_______________________________#
#_______________________________#
#_______________________________#
#_______________________________#
#_______________________________#
#_______________________________#
#_______________________________#
#_______________________________#
#_______________________________#
#_______________________________#
#_______________________________#
#_______________________________#
#_______________________________#
#E_____________________________E#
#################################